NO assets/south.xpm
SO assets/north.xpm
WE assets/west.xpm
EA assets/east.xpm

F 220,100,0
C 225,30,55

1111111111111111
1110000000011111
1111100001111111
1110010111111111
1100001111111111
1100N00111111111
1111111111111111
