NO assets/south.xpm
SO assets/north.xpm
WE assets/west.xpm
EA assets/east.xpm

F 220,100,0
C 225,30,55

1111111111
1011011111
1111N00001
1010101011
1111111111