NO ./assets/south.xpm
SO ./assets/north.xpm
WE ./assets/west.xpm
EA ./assets/east.xpm

F 220,100,0
C 225,30,55

1111111111
11110111111
1111N0000101
101010101111
1111111111