NO ./assets/north.xpm
SO ./assets/south.xpm
WE ./assets/west.xpm
EA ./assets/east.xpm

F 220,100,0
C 225,30,55

111111111111
1011000000001
111110000111
1100101111111
10000011111111
100N00000000011
11111111111111
11111111
11111111
11111111
