NO ./assets/south.xpm
SO ./assets/north.xpm
WE ./assets/west.xpm
EA ./assets/east.xpm

F 220,100,0
C 225,30,55

1111111111111111
1110000000011111
1111100001111111
11100001111111001
110000011111110101
1100N0011111111101
11111111111111111
1111111111111111